.*..**..**
**********
.*..**..**
**********
.*..**..**
**********
.*..**..**
**********
.*..**..**
**********
...***..**